# Syntax Coloring Map For ExampleLibrary

# Datatypes (KEYWORD1)
VGAXUA	KEYWORD1
VGAXUAUtils	KEYWORD1

# Methods and Functions (KEYWORD2)
begin	KEYWORD2
end	KEYWORD2
putpixel	KEYWORD2
getpixel	KEYWORD2
putpixel8	KEYWORD2
getpixel8	KEYWORD2
clear	KEYWORD2
copy	KEYWORD2
setExtendedColorsMask	KEYWORD2
bitblit	KEYWORD2
blit	KEYWORD2
blitwmask	KEYWORD2
fillrect	KEYWORD2
printPROGMEM	KEYWORD2
printSRAM	KEYWORD2
delay	KEYWORD2
millis	KEYWORD2
micros	KEYWORD2
tone	KEYWORD2
noTone	KEYWORD2
rand	KEYWORD2

# Instances (KEYWORD2)
vgaxfb	KEYWORD2
vtimer	KEYWORD2

# Constants (LITERAL1)
VGAX_HEIGHT	LITERAL1
VGAX_BWIDTH	LITERAL1
VGAX_WIDTH	LITERAL1
VGAX_BSIZE	LITERAL1
VGAX_SIZE	LITERAL1
VGAX_ECSWIDTH	LITERAL1